











NO ./varys.xpm

EA ./varys.xpm
SO ./varys.xpm

WE ./varys.xpm

F 220,100,42

C 225,30,25














11111
10001
10N01
10001
11111
  111111111111111111111111111111111111111111111111111111111111
  111111111111111111111111111111111111111111111111111111111111
  111111111111111111111111111111111111111111111111111111111111
  111111111111111111111111111111111111111111111111111111111111
  111111111111111111111111111111111111111111111111111111111111
  111000000000000000000000000000000000000000000000000000000111
  111000000000000000000000000000000000000000000000000000000111
  111000000000000000000000000000000000000000000000000000000111
  111000000000000000000000000000000000000000000000000000000111
  111000000000000000000000000000000000000000000000000000000111
  111000000000000000000000000000000000000000000000000000000111
  111000000000000000000000000000000111000000000000000000000111
  111000000000000000000000000000000000000000000000000000000111
  111000000000000000000000000000000000000000000000000000000111
  111000000000000000000000000000000000000000000000000000000111
  111000000000000000000000000000000000000000000000000000000111
  111000000000000000000000000000000000000000000000000000000111
  111000000000000000000000000000000000000000000000000000000111
  111000000000000000000000000000000000000000000000000000000111
  111111111111111111111111111111111111111111111111111111111111
  111111111111111111111111111111111111111111111111111111111111
  111111111111111111111111111111111111111111111111111111111111
