











NO ./varys.xpm

EA ./varys.xpm
SO ./varys.xpm

WE ./varys.xpm

F 220,200,42

C 225,30,25


111111111111
1111100001111
1111100001111
1111100001111
1111100001111
1000000000000111111111111111
1000000N000000000000000000001
10000000000001111111111100001
10000000000001111111111111111
1111100001111
1111100001111
1111100001111
1111100001111
1111100001111
1111100001111
1111100001111
1111100001111
1111100001111
1111100001111
1111100001111
1111100001111
10000000000001
10000000000001
10000000000001
10000000000001
1111111111111
