NO ./varys.xpm

EA ./textures/amarillo.xpm
SO ./textures/YM.xpm

WE ./textures/l.xpm

F 187,179,147

C 211,129,66

11111111111111
1S0000001
1010000001
1001000001
1000100001
1000010001
100000100111
1000000000001
1000000100001
10000000000001
10000000000001
10000000000001
11111111111111