SO ./textures/DonOmar.xpm
NO ./textures/DY.xpm

F 250,0,123

EA ./textures/ozuna.xpm

C 5,5,42

WE ./textures/Crisipo.xpm


111111111111111111111111111111111111111111111111111111111111111111111111111111111111111111111111111111111111111111111111111111111111111111
1S0000000000000000000000000000000000000000000000011111111111111111110000001000000000000000000000000000000000000000000000000000000000000001
101111111111111110111111111111111111111111111111011111111111111111110111101000000000000000000000000000000000000000000000000000000000000001111111
101000000000000010000000000000000000000000000000000000000000000000000001101111111000000000000000000000000000000000000000000000000000000000000001
101011111111110111011111111111101111111111111111111111111111111111011101000000001000000000000000000000000000000000000000000000000000000000000001
101010000000010000010000000000001000000000000000000000000000000010001111000000001000000000000000000000000000000000000000000000000000000000000001
101010111111111011010111111111101011111111111111111111111111111110111101000000001000000000000000000000000000000000000000000000000000000000000001
101000100000000010010000000000001000000000000000000000000000000010001111000000001000000000000000000000000000000000000000000000000000000000000001
101111101111101111011111011111101111111111111111111111111111111110111101000000001000000000000000000000000000000000000000000000000000000000000001
100000001000000000000001000000000000000000000000000000000000000010001000000000000000000000000000000000000000000000000000000000000000000000000001
101111101011111111011101111111111011111111111111111111111111111110111101000000001000000000000000000000000000000000000000000000000000000000000001
101000001000000010000001000000001000000000000000000000000000000010001101000000001000000000000000000000000000000000000000000000000000000000000001
101011111011111011111101111111101111111111111111111111111111111110111101000000001000000000000000000000000000000000000000000000000000000000000001
101000001000000010000001000000001000000000000000000000000000000010001011000000001000000000000000000000000000000000000000000000000000000000000001
101111101111101111011111011111101111111111111111111111111111111110111101000000001000000000000000000000000000000000000000000000000000000000000001
100000000000000000000000000000000000000000000000000000000000000010001111000000001000000000000000000000000000000000000000000000000000000000000001
101111111111111111111111111111111111111111111111111111111111111110111101000000001000000000000000000000000000000000000000000000000000000000000001
100000000000000000000000000000000000000000000000000000000000000000001111000000001000000000000000000000000000000000000000000000000000000000000001
11111111111111111111111111111111111111111111111111111111111111111111111111111111111111111111111111111111111111111111111111111111111111111011111
101111111111111111111111111111111111111111111111111111111111111110111101000000001000000000000000000000000000000000000000000000000000000000000001
100000000000000000000000000000000000000000000000000000000000000000000000000000000000000000000000000000000000000000000000000000000000000000000001
11111111111111111111111111111111111111111111111111111111111111111111111111111111111111111111111111111111111111111111111111111111111111111111111