SO ./textures/c.xpm
NO ./textures/o.xpm

F 123,69,10

EA ./textures/e.xpm

C 42,200,66

WE ./textures/p.xpm


1111111111111111111111111111111111
1E00000000000000000000000000000001
1010010100100000101001000000010101
1010010010101010001001000000010101
1000000000000000000000000000000001
1111111111111111111111111111111111