











NO ./textures/no_texture.xpm

EA ./textures/ea_texture.xpm
SO ./textures/so_texture.xpm

WE ./textures/we_texture.xpm

F 87,79,47

C 11,129,66


1111111111111111111111111111111111111111111111111111111111111111111111111111111111111111111111111111111111111111111111111111111111111111111111111111111111111111111111111111111111111111111111111111111111111111111111111111111111111111111111111111111111111111
1111111111111111111111111111111111111111111111111111111111111111111111111111111111111111111111111111111111111111111111111111111111111111111111111111111111111111111111111111111111111111111111111111111111111111111111111111111111111111111111111111111111111111
1111111111111111111111111000001111111111111111111001111111111111111111111110000111100000000000111111111001111111111111111111111111111110011111111111000000000111110000000000001111100000000000111111111100001110001111000011111111111111111111111100000000000011
1111111111111111110111111000001111111111110011111000111111111111111111111100000000001100001100011111000000111111111111111111111111110000001111111000001000000011100111111111000111000011100000011111111000001100000110000001111111111111111111111100110111011011
1111111111111111100111111000000111111111110001111000011111111111111111111000000000011110011110011110000000111111111111100111111111100000001111111000010000000001100111111111000110010111110100011111111000000000000000000000111111111111111111111100110111011011
1111111000000000000000000000000000000000000000000000000000011111110000110000000000011110011110000000000000000000000000000000000000000000000000000000101010101001100111111111000110000000000000011111100000000000000000000000001111111011111111111100000000000011
1111111011111111100000000000000111101111110000000000011111011111100000000000000000011110011110011110000000111111111101100111111111100000001111111000010000000001100111111111000110010100010100011111101000000000000000000000000111111011111111111100000000000011
1111111011111111110000000000001111101111110000000000111111011111100000000000000000000000000000011111000000111111111101111111111111110000001111111000001000000011100000100000000111000000000000011111101000001100000110000000000111111011111111111100000000000011
1111111011111111110000000000001111101111111000000001111111011111110000110000000111100000000000111111111001111111111101111111111111111110011111111111000000000111110000100000001111100000000000111111101100001110001111000000001111111011111111111100000000000011
1111111011111111111111101111111111101111111111111111111111011111111111111111111111111111111111111111111111111111111101111111111111111111111111111111111111111111111111111111101111111110111111111111101111111111111111111111101111111011111111111111111101111111
1111111011111111111111101111111111101111111111111111111111011111111111111111111111111111111111111111111111111111111101111111111111111111111111111111111111111111111111111111101111111110111111111111101111111111111111111111101111111011111111111111111101111111
1111111011111111111111101111111111101111111111111111111111011111111111111111111111111111111111111111111111111111111101111111111111111111111111111111111111111111111111111111101111111110111111111111101111111111111111111111101111111011111111111111111111111111
1111111011111111111111101111111111101111111111111111111111011111111111111111111111111111111111111111111111111111111101111111111111111111111111111111111111111111111111111111101111111110111111111111101111111111111111111111101111111011111111111111111111111111
1110000000000000000000000000001111101111000000000001111111011110000000000000001111111111001100111100110011111110001101111111111111111111111111111111111111111111111111111111101111100000000001111100000000000000000011111111101111111011110000000000000000000011
1100100000011001100110000000100111101110011011011000111111011100000000000000000111111111000000000000000011111100000101111111111111111111111111111111111111111111111111111111101111000100000000111000000000000000000001111111101111111011100000000011011100110011
1000001000011001100110000010000111101100011011011000011111011000000100100100010111111111000000000000000011111000000101111111111111111111111111111111111111111111111111111111101111010000101000111000000101010100000001111100000000000001100000000011011100110011
1000100010000000000000001000100111000000000000000000000000000000000000000000000001100110000000000000000000000000000000100000000000000000000000000000000000000000000000000000000000000100000010000000000000000000000101100000000000000000000000000000000000000011
1000001000001100001100000010000110000000001101100000000000000000000100100100010000000000000000000000000000011000000000100000000000000000000000000000000000000000000000000000000111010000101000111000000101010100000001000111111111111111100000000000110011011011
1100100000001100001100000000100110000000001101100000000000000000000000000000000000000000000000000000000000011100000000100000000000000000111111111111111111111111111111100000000111000100000000111000000000000000000001000111111111111111100000000000110011011011
1110000000000000000000000000001111000000000000000000000000000000000000000000000001100110001100111100110000011110000000100000000000000000111111111111111111111111111111100000000111100000000001111100000000000000000011100111111111111111100000000000000000000011
1111111111111111111111111111111111111111111111111111111111111111111111111101111111101111111110111111111111111111111111100001111111111111111111111111111111111111111111111111111111111110111111111110111111111111110111100111111111111111111111111111111111111111
1111111111111111111111111111111111111111111111111111111111111111111111111101111111101111111110111111111111111111111111100001111111111111111111111111111111111111111111111111111111111110111111111110111111111111110111100111111111111111111111111111111111111111
1111111111111111111111111111111111111111111111111111111111111111111111111101111111101111111110111111111111111111111111100001111111111111111111111111111111111111111111111111111111111111111111111110111111111111110111100111111111111111111111111111111111111111
1111111111111111111111111111111111111111111111111111111111111111111111111101111111101111111110111111111111111111111111100001111111111111111111111111111111111111111111111111111111111111111111111110111111111111110111100111111111111111111111111111111111111111
1110000000000000000000000000001111000000000000111100000111100000000110000000000000000000000000111100011110111111111111100001110000000000000000100000000000000000000000000000000000000000000000000000000000001111110100000111111111111111111111111000000000000111
1101001001001000000100100100101111000011110000111000000011000000000000000000000000000000000000011000001100111111111111100001110000000000000100000000000000000000000000000000000000000000000000000000001111001111110100000111111111111111111111111011011101100111
1100000000000000000000000000001111011111111110111000100011000000001001001001001000100100100100011000000000000000000000100000000000000000000001000000000000000000000000000000000000000000000000000000011111101111110100000111111111111111111111111011011101100111
1101001001001000000100100100101111000000000000111001010011000000000000000000000000000000000000011000000000000000000000100000000000000000000100000000000000000000000000000000000000000000000000000000011111100000000000000000000000000000011111111000000000000111
1100000000000000000000000000001111011100001110111000100011000000001001001001001000100100100100011000000001111111111111111111111111111110000001000000000000000000000000000000000000000000000000000000011111100000000000000000000000000000011111111000000000000111
1101001001001000000100100100101111000000000000111000000011000000000000000000000000000000000000011000001101111111111111111111111111111110000100000000000000000000000000000000000000000000000000000000000000000000000000000000000000000000011111111000000000000111
1100000000000000000000000000001111000000000000111100000111100000000110000000000000000000000000111100011111111111111111111111111111111110000000100000000000000000000000000000000000000000000000000000000000000000000000000000000000000000011111111000000000000111
1100000000000011110000000000001111111110111111111111110111111011111111111111111111110111111111111100111111111111111111111111111111111110011111111111111111111111110000000000000110000000000000111111111111111111111111100111111111000000011111111111110111111111
1100000000000011110000000000001111111110111111111111110111111011111111111111111111110111111111111100111111111111111111111111111111111110011111111111111111111111110000000000000110000000000000111111111111111111111111100111111111000000011111111111110111111111
1100000000000011110000000000001111111110111111111111110111111011111111111111111111110111111111111100111111111111111111111111111111111110011111111111111111111111110000000000000110000000000000111111111111111111111111100111111111000000011111111111111111111111
1100000000000011110000000000001111111110111111111111110111111011111111111111111111110111111111111100111111111111111111111111111111111110011111111111111111111111110000000000000110000000000000111111111111111111111111100111111111000000011111111111111111111111
1100000000000000000000000000001111111110100111111100000000000011110000000000001111110111111111111100111111111111110000000000001111111110001000011100000000000011110000000000000000000000000000111110000000000011100000000000000111000000011111111111111111111111
1101001001001000000100100100101111001110100011111100000000000011100000000000001111110111111111111100111111111111110110111011001111111110000000011000011111100001110000000000000000000000000000111100001110000001101010000001000111000000011111111111111111111111
1100000000000000000000000000000000000110100001111101010101010011101010100000000111110000000000000000000001111111110110111011001111111110000010011001011111101001110000000000000000000000000000111001011111010001100000100100010111000000011111111111110111111111
1101001001001000000100100100100000000000000000000000000000000011100000000000000111110000000000000000000001111111110000000000000000000000000000011000011111100001110000000000000000000000000000111000000000000001101010000001000111000000000000000000000001111111
1100000000000000000000000000000000000000000001111101010101010011101010100111111111111111111111111111111111111111110011000110001111111110000010011001011111101001110000000000000000000000000000111001010001010001100000000000010111000000000000000000000001111111
1101001001001000000100100100101111000000000001111100000000000011100000000111111111111111111111111111111111111111110011000110001111111110000000011000000000000001110000000000000000000000000000111100000000000001101010000001000111000000000000000000000001111111
1100000000000000000000000000001111100000000001111100000000000011110000000111111111111111111111111111111111111111110000000000001111111110001000011100000000000011110000000000000000000000000000111110000000000011100000000000000111100000000000000000000001111111
1100000000000011110000000000001111111111111111111111111111111111111111110111111111111111111111111111111111111111111111111111111111111110011111111111111001111111111111100111111111111111111100111111111011111111101010100101010111111111111111111111100001111111
1100000000000011110000000000001111111111111111111111111111111111111111110111111111111111111111111111111111111111111111111111111111111110011111111111111001111111111111100111111111111111111100111111111011111111101010100101010111111111111111111111100001111111
1100000000000011110000000000001111111111111111111111111111111111111111110111111111111111111111111111111111111111111111111111111111111110011111111111111001111111111111100111111111111111111100111111111011111111101010100101010111111111111111111111100001111111
1100000000000011110000000000001111111111111111111111111111111111111111110111111111111111111111111111111111111111111111111111111111111110011111111111111001111111111111100111111111111111111100111111111011111111101010100101010111111111111111111111100001111111
1100000000000000000000000000001111000000000000111100000000000011110000000111111111000000000000111111111111111111111111111111111111111110000001111100011001111111111000000000011110000000001100111100001011100111100000000000000111000000000000111111000001111111
1101001001001000000100100100101110000111111000011000011111100001100000000111111111001101110110111111111111111111111111111111111111111110000001111100011001111111110000000000001110000010001100111100001011100111100000100001000110000000000000011111000001111111
1100000000000000000000000000001110010111111010011001011111101001100101000111111111001101110110111111111111111111111111111111111111111110000001111100000000000000000001000010000000000000101100111000001011100111001010000100010000000100001000011111000001111111
1101001001001000000100100100101110000111111000011000011111100001100000000111111111000000000000111111111000000000000000000000000000000000000001111101000000000000000000000000000000100010001100111000000000000000000000100001000000000000000000011110000001010111
1100000000000000000000000000001110010111111010011001011111101001100101000111111111000000000000111111111000000000000000000000000000000000000001111100000000000000000001000010000000000000101100111000000000000111001010000100010000000000000000011100000001111111
1101001001001000000100100100101110000000000000011000000000000001100000000111111111000000000000111111111001111111111111111111111111100000000001111100011001111111110000000000001110000010001100111100000000000111100000100001000110000000000000011100000001111111
1110000000000000000000000000001111000000000000111100000000000011110000000111111111000000000000111111111001111111111111111111111111100000000001111100011001111111111000000000011110000000001100111100000000000111100000000000000111000000000000111110000001111111
1111111111111101111111111111111111111110011111111111111001111111111111100111111111111111011111111111111001111111111111111111111111111110011111111111111001111111111111111111111110100010101100111111111111111111111011111111011111111111111111111111100001111111
1111111111111101111111111111111111111110011111111111111001111111111111100111111111111111011111111111111001111111111111111111111111111110011111111111111001111111111111111111111110100010101100111111111111111111111011111111011111111111111111111111100001111111
1111111111111101111111111111111111111110011111111111111001111111111111100111111111111111111111111111111001111111111111111111111111111110011111111111111001111111111111111111111110100010101100111111111111111111111011111111011111111111111111111111100001111111
1111111111111101111111111111111111111110011111111111111001111111111111100111111111111111111111111111111001111111111111111111111111111110011111111111111001111111111111111111111110100010101100111111111111111111111011111111011111111111111111111111100001111111
1111111111111101110000000000111111000000000000000000000000000011110000000111111111111111111111111111111000000000000000000000000000000000000000011111111001111111111000000000000000000000000000000000000000000111111011111111011111000000111100111111000001111111
1111111111111101100000000000111111001111111111111100000000000001110001000111111111111111111111111111111000000000000000010100010110100010010100011111111001111111111000000000000000000000001000011111111111110111111011111111011110000000011000011111000001111111
1111111111111101100101010100000000001111111111111100001000000000000000000111111111111111011111111111111000101100000000000000000000000000000000000000000000000000000000000000010000100010100000011111111111110000000000000000000000001000000010011111000001111111
1100000000000001100000000000000000001111111111111100000000100000000001000000000000000110000000000000000000000000000101010101010110101010010101000000000000000000000000000000000000000000001000011111111111110000000000000000000000000000000000011110000001010111
1100000000000001100101010100000000001111111111111100001000000000000000000000001111000110000000111110000000101100000000000000000000000000000000000000000001111111111111100000010000100010100000011111111111110000000000000000000000001000000010011100000001111111
1100000000000001100000000000111111001111111111111100000000000001110001000000001111000110000000111110000000000000000000010100010110100010010100011111111001111111111111100000000000000000001000011111111111110111111011111111011110000000011000011100000001111111
1100000000000001110000000000111111000000000000000000000000000011110000000000001111000110000000111110000000000000000000000000000000000000000000011111111001111111111111100000000000000000000000000000011111110111111011111111011111000000111100111110000001111111
1100000000000011111111111100111111111001100000111111001000101011111001111001101111000110001010111111111111111111111111111111111111101010010101011111111001111111111111100001110110100010101101111111011111110111111011111111011111111111111111111111100001111111
1100000000000011111111111100111111111001100000111111001000101011111001111001101111000110001010111111111111111111111111111111111111101010010101011111111001111111111111100001110110100010101101111111011111110111111011111111011111111111111111111111100001111111
1100000000000011111111111100111111111001100000111111001000101011111001111001101111000110001010111111111111111111111111111111111111101010010101011111111001111111111111100001110110100010101101111111011111110111111011111111011111111111111111111111100001111111
1100000000000011111111111100111111111001100000111111001000101011111001111001101111000110001010111111111111111111111111111111111111101010010101011111111001111111111111100001110110100010101101111111011111110111111011111111011111111111111111111111100001111111
1100000000000011111111111100111111111000100000111100000000000011111000000000000000000110000000000000000000000011110000000110001111000000000000011100000001111111111111100000000000000000000000111111011000000000000000000010011111000000000000000000000001111111
1100000000000001111111111100111111111000100000000001000000100001110000000000000000000110001000000001111000000001100101000000100110001000010001011000010001111111111111100000000000000000001000011111010000000111110011111111011110011100000000000000000001111111
1100000000000000000000000000000000000000100000000000001000000000000000100000000000000110000010000000000011100000000000000000000000100000000000000010000001111111111111100000100000100010100000000000010000000111110011111111000000000000001111000000000001111111
1100000000000000000000000000000000000000100000000001000000101000000000000000000000000000001000000001111000000000000101000000100000001010010101000000010000000000000000000000000000000000001000000000010000000111110011111111000000011101100000000000000001111111
1100000000000000000000000000000000000000100000000000001000000000000000100000000000000110000010000000000011100000000000000000000000100000000000000010000000000000000000000000100000100010100000000000010000000111110011111111000000000000001111000000000001111111
1100000000000001111111111100111111111100111111000001000000100001110000000000000000000110001000000001111000000001100101000000100110001000010001011000010000000000000000000000000000000000001000011111110000000111110011111111111110011100000000000000000001111111
1100000000000011111111111100111111111100111111111100000000000011111000000000000000000110000000000000000000000011110000000110001111000000000000011100000000000000000000000000000000000000000000111111111000000000000011111111111111000000000000000000000001111111
1111111111111111111111111100111111111100111111111111111000101011111111111111111111110111111111111111111111110011111111100111111111101010010101011111111111111111111111111111111111111111111000111111111111111111111111111111111111111111111111111111100001111111
1111111111111111111111111100111111111100111111111111111000101011111111111111111111110111111111111111111111110011111111100111111111101010010101011111111111111111111111111111111111111111111000111111111111111111111111111111111111111111111111111111100001111111
1111111111111111111111111100111111111100111111111111111000101011111111111111111111110111111111111111111111110011111111100111111111101010010101011111111111111111111111111111111111111111111000111111111111111111111111111111111111111111111111111111100001111111
1111111111111111111111111100111111111100111111111111111000101011111111111111111111110111111111111111111111110011111111100111111111101010010101011111111111111111111111111111111111111111111000111111111111111111111111111111111111111111111111111111100001111111
1111000000000000000000000000011111111100000000000000000000000011110000000000001111000110000000000000000000000011111100000111111111000000000000000111110000001111111111100111111111111110000000000000000000000000000000000000000000111111111111111111100001111111
1110011011000000000000000000001111111111111111111111111000000001100000011100000110000110100010000000000010000011111000000111111111000010010101000011110000000111111100000011111111111100000000000000000000000000000000000000000000111111111111111111100001111111
1100011011000000000000000000000000111111111111111111111000000000000010111110100110000110001000000000000000100001110000000111111110101000000000000001110001000111111000000011111111111000000000000000000000000000000000000000000000000000000000000000000001111111
1000000000000000000000000000000000000011111111111111111000100000000000000000000110010110100010000010010010000000000000000000000000000010010101000000110010100000000000000000000000000000000000000000000000000000000000000000000000000000000000000000000001111111
11000011011000000000000000000000000000111111111111111110000000000000101000101001100001100010000000000000001000011100000N0000001110101000000000000000000001000111111000000011111111111001111111111111111111111111111111111111111111111111111111111111111111111111
1110001101100000000000000000001111000011111111111111111000000001100000000000000110000110100010000000000010000011110000000000001111000010010101000000000000000111111100000011111111111101111111111111111111111111111111111111111111111111111111111111111111111111
1111000000000000000000000000011111000000000000000000000000000011110000000000001111000110000000000000000000000011110000000000001111000000000000000000110000001111111111100111111111111111111111111111111111111111111111111111111111111111111111111111111111111111
1111111111111111111111111111111111111111111111111111111111111111111111111111111111111111111111111111111111111111111111111111111111111111111111111111111111111111111111111111111111111111111111111111111111111111111111111111111111111111111111111111111111111111
1111111111111111111111111111111111111111111111111111111111111111111111111111111111111111111111111111111111111111111111111111111111111111111111111111111111111111111111111111111111111111111111111111111111111111111111111111111111111111111111111111111111111111
